20 20
0 0 1 0 0 0 0 0 0 0 0 0 0 0 1 0 0 0 0 0
0 0 1 0 0 0 0 0 0 0 0 0 0 0 1 0 0 0 0 0
0 0 1 0 0 1 1 1 1 1 1 1 0 0 1 1 1 1 0 0
0 0 1 0 3 1 0 0 0 0 0 1 0 0 0 0 0 0 0 0
0 0 1 0 0 1 0 0 0 0 0 1 0 0 0 0 0 0 0 0
0 0 0 0 0 0 0 0 0 0 0 1 0 0 0 0 0 0 0 0
0 0 0 0 0 0 0 0 0 0 0 1 0 0 0 0 0 0 0 0
1 1 1 1 1 1 1 1 1 0 0 1 0 0 1 1 1 1 0 0
0 0 0 0 0 0 0 0 1 0 0 1 0 0 1 0 0 1 0 0
0 0 0 0 0 0 0 0 1 0 0 1 0 0 1 0 0 1 0 0
0 0 1 1 1 1 0 0 1 0 0 1 0 0 0 0 0 1 0 0
0 0 1 0 0 1 0 0 0 0 0 1 0 0 0 0 0 1 0 0
0 0 1 2 0 1 0 0 0 0 0 1 1 1 1 1 1 1 0 0
0 0 1 0 0 1 0 0 1 0 0 0 0 0 0 0 0 0 0 0
0 0 0 0 0 1 0 0 1 0 0 0 0 0 0 0 0 0 0 0
0 0 0 0 0 1 1 1 1 0 0 1 1 1 1 1 1 1 1 0
0 0 1 0 0 0 0 0 0 0 0 1 0 1 0 0 0 1 0 0
0 0 1 0 0 0 0 0 0 0 0 1 0 0 0 1 0 1 0 1
0 0 1 1 1 1 1 1 1 1 1 1 0 1 0 1 0 1 0 0
0 0 1 0 0 0 0 0 0 0 0 0 0 1 0 1 0 0 0 0
4 8 7 8
4 15 5 18