20 20
0 0 0 0 0 0 0 1 1 1 1 0 0 0 0 0 0 0 0 0
0 2 0 0 0 0 0 1 1 1 1 0 0 0 0 0 1 0 1 0
0 0 0 0 0 0 0 0 1 1 0 0 0 0 0 0 1 1 1 0
0 0 0 0 0 0 0 0 0 0 0 0 0 0 0 0 0 1 0 0
0 0 0 0 0 0 0 0 0 0 0 0 0 1 0 0 0 1 0 0
0 0 0 1 1 1 0 0 0 0 0 0 1 1 1 0 0 0 0 0
0 0 0 1 1 1 0 0 0 0 0 1 1 1 1 1 0 0 0 0
0 0 0 1 1 1 0 0 0 0 0 0 1 1 1 0 0 2 0 0
0 0 0 0 0 0 0 0 3 0 0 0 0 1 0 0 0 0 0 0
0 0 0 0 0 0 0 0 0 0 0 0 0 0 0 0 0 0 0 0
0 0 0 0 0 0 0 0 0 0 0 0 0 0 0 0 0 0 0 0
0 0 0 0 0 0 0 0 0 0 0 0 0 0 0 0 0 0 0 0
0 0 0 0 0 0 0 1 1 1 1 1 0 0 0 0 0 0 0 0
0 0 0 0 0 0 1 1 1 1 1 1 1 0 0 0 0 0 0 0
0 0 0 0 0 0 0 1 1 1 1 1 0 0 0 0 0 1 1 0
0 0 0 0 0 0 0 0 1 1 1 0 0 0 0 0 1 1 1 1
0 0 0 1 0 0 0 0 0 1 0 0 0 0 0 0 1 1 1 1
0 0 1 1 0 0 0 0 0 0 0 0 0 0 0 0 0 1 1 0
0 1 1 0 0 2 0 0 0 0 0 0 0 0 0 0 0 0 0 0
1 1 0 0 0 0 0 0 0 0 0 0 0 0 0 0 0 0 0 0
10 0 11 1
10 16 11 17